0000000000000000000000000000000000000000000000000000000000000000
0000000000111111111111111111110000000000000000000000000000000000
0000000000111111111111111111110000000000000000000000000000000000
0000000000111111111111111111110000000000000000000000000000000000
0000000000111111000000001111110000000000000000000000000000000000
1111111111111111000000001111111111111111111111111111111122222222
1111111111111111000000001111111111111111111111111111111122222222
1111111111111111000000001111111111111111111111111111111122222222
0000000000000000000000000000000000000000000000000000000000000000
0000000000000000000000000000000000000000000000000000000000000000
0000000000000000000000000000000000000000000000000000000000000000
