0000000000000000000000000000000000000000000000000000000000000000
0000000000000000000000000000000000000000000000000000000000000000
0000000000000000000000000000000000000000000000000000000000000000
0000000000111111111111111111110000000000000000000000000000000000
0000000000111111111111111111110000000000000000000000000000000000
0000000000111111111111111111110000000000000000000000000000000000
0000000000111111222222221111110000000000000000000000000000000000
1111111111111111222222221111111111111111111111111111111111133333
1111111111111111222222221111111111111111111111111111111111133333
1111111111111111222222221111111111111111111111111111111111133333
2222222222222222222222222222222222222222222222222222222222222222
0000000000000000000000000000000000000000000000000000000000000000
0000000000000000000000000000000000000000000000000000000000000000
