000000000000000000000000000000000000000000000000000000000000000000000000000000000000000000000000000000000
000000000000000000000000000000000000000000000000000000000000000000000000000000000000000000000000000000000
001111111111111111111111111111111111110000011111111111111111111111111111111111000001111111111111110000000
001111111111111111111111111111111111110000011111111111111111111111111111111111000001111111111111111111100
001111111222000000000000000011111111110000011111111110000011111111111111111111111111111100000111111111100
001111111111000000000000000011111111110000022222111110000011111111111111111111111111111100000222221111100
002222211111000000000000000022222111110000011111111110000011111111111111111111000000000000000111111111100
001111111111000000000000000011111111110000011111111110000011111111111111111111000000000000000111112222200
001111111111000000000000000011111111110000011111222220000000000000000000000000000001111111111111111111100
001111122222000000000000000011111222220000011111111111111100000000000000000000000001111111111111111111100
001111111111111111111110000011111111110000011111111111111111111000000000000000000001111111111000000000000
001111111111111111111110000022221111110000000000000001111111111000000000000000000001111111111000000000000
000000000000111111111110000011111111110000000000000001111122222000000000000000000001111122222000000000000
000000000000111111111110000011111111111111111111111111111111111000001111111111111111111111111000000000000
000000000000222221111110000011111111111111111111111111111111111000001111111111111111111111111000000000000
001111111111111111111110000000000000000000000000000000000000000000001111111111111110000000000000000000000
001111111111111111111110000000000000000000000000000000000000000000001111111111111110000000000000000000000
001111122222000000000000000011111111111111111111111111111111111111111111111111000000000000000000000000000
001111111111000000000000000011111111111111111111111111111111111111111111111111000000000000000000000000000
001111111111000000000000000011111111110000000000000000000000000000000000000000000000000000000000000000000
000000011111111111000000000011111111110000000000000000000000000000000000000000000000000000000000000000000
000000011111111111000000000022222111110000000000000000000000000000000000000000000000000000000000000000000
000000000000111111111110000011111111110000000000000000000000000000001111111111111111111111111000000000000
000000000000111111111110000011111222220000000000000000000000000000001111111111111111111111111000000000000
000000000000222221111110000011111111110000000000000000000000000000001111122222222222222211111000000000000
000000000000111111111110000022222111110000000000000000000000000000001111111111111111111111111111111133333
000000000000111111111110000011111111110000000000000000000000000000002222211111111111111111111111111133333
000000000000111111222220000011111222220000000000000000000000000000001111111111111111111122222000000000000
000000000000111111111110000011111111110000000000000000000000000000001111122222111111111111111000000000000
111111111111111111111110000011111111111111111111111111111111111111111111111111111111111111111000000000000
111111111111111111111110000000000111111111111111111111111111111111111111111111111111111111111000000000000
000000000000000000000000000000000000000000000000000000000000000000000000000000000000000000000000000000000
000000000000000000000000000000000000000000000000000000000000000000000000000000000000000000000000000000000
